------------------------------------------------------------------------------------------------------------------------------------------------------
------------------------------------------------------------------------------------------------------------------------------------------------------
------------------------------------------------------------------------------------------------------------------------------------------------------
------------------------------------------------------------------------------------------------------------------------------------------------------
------------------------------------------------------------------------------------------------------------------------------------------------------
------------------------------------------------------------------------------------------------------------------------------------------------------
------------------------------------------------------------------------------------------------------------------------------------------------------
--------------------------2ooo-----2Co-----------------------------------2ooo-------------------------------------------------------------------------
------------------------------------------------------oo2oo--------------------g---o2ooo----------------22Co-----------------------------g------------
----------------------oCo-------g--------------------*----------2Co------------2oo--------*---------------------------------------tt--CoCC-o2oo-------
----------XXXooo22--tt---------o2oXXX----------oo2---*-----tt----------------------------ooC------------------------------------g-tt------------------
----------XXXXttX---tt----------XXXXX---CCooo----XXXX*XX---ttXXXXXXXXooCXXXXXXXXX---------*--2oC---o2oXXXX---CoCo-----oooo2----22ooo------------------
-M--------XXXXttX---tt--------ggXXXXX-ggg--y-----XXXX*XXk-rttXXXXXXXXXXXXXXXXXXXX-----g--k*-------gXXXXXXXkr---g----y--------g---gttg-g-gyg---------F-
XXXXXXXXXXXXXXXXXXXXXXXXXXXXXXXXXXXXXXXXXXXXXXXX-XXXXXXXXXXXXXXXXXXXXXXXXXXXXXXXXXXXXXXXXXXXXXXXXXXXXXXXXXXXXXXXXXXXXXXXXXXXXXXXXXXXXXXXXXXXXXXXXXXXXX
XXXXXXXXXXXXXXXXXXXXXXXXXXXXXXXXXXXXXXXXXXXXXXXX-XXXXXXXXXXXXXXXXXXXXXXXXXXXXXXXXXXXXXXXXXXXXXXXXXXXXXXXXXXXXXXXXXXXXXXXXXXXXXXXXXXXXXXXXXXXXXXXXXXXXX
XXXXXXXXXXXXXXXXXXXXXXXXXXXXXXXXXXXXXXXXXXXXXXXX-XXXXXXXXXXXXXXXXXXXXXXXXXXXXXXXXXXXXXXXXXXXXXXXXXXXXXXXXXXXXXXXXXXXXXXXXXXXXXXXXXXXXXXXXXXXXXXXXXXXXX
