------------------------------------------------------------------------------------------------------------------------------------------------------
------------------------------------------------------------------------------------------------------------------------------------------------------
------------------------------------------------------------------------------------------------------------------------------------------------------
------------------------------------------------------------------------------------------------------------------------SSSSSSSSSS--------------------
------------------------------------------------------------------------------------------------------------------------------------------------------
------------------------------------------------------------------------------------------------------------------------------------------------k-----
------------------SC-----------------------------------------------------------------SSSS-----------------2---?SSS-----------------------------SQS--SQ
------------------------------------------------------------------------------------------------------------------------------------------------------
-------------------------------------------------------------------------------g----------------------------------------------------------------------
----------------------------------------------------------------------------------------------------o-------------------------------------------------
--------------TT---2---------------------------------------------------------S@SQ---------------TT--------2---SSSSS----------------------------SQS--S?
--------------TT------------------------T-----TT----K-------------------------------------------TT------------------------SS---------TT---------------
--------------TT------------------------T-----TT------------------------------------------------TT------------------------SS---------TT---------------
-M------------TT---------ggg------k-k---T-----TT-----------g-y-------------------ggg--------k---TT------y--y----K---------SS---------TT------k------gg
XXXXXXXXXXXXXXXXXXXXXXXXXXXXXXXXXXXXXXX-XXXX--XXXXXXXXXXXXXXXXXXXXXXXX-XXXXXXXXXXXXXX----XXXXXXXXXXXXXXXXXXXXXXXXXXXXXXX--XX--XXXXXXXXXXXXXXXXXXXXXXXX
XXXXXXXXXXXXXXXXXXXXXXXXXXXXXXXXXXXXXXX-XXXX--XXXXXXXXXXXXXXXXXXXXXXXX-XXXXXXXXXXXXXX----XXXXXXXXXXXXXXXXXXXXXXXXXXXXXXX--XX--XXXXXXXXXXXXXXXXXXXXXXXX
