------------------------------------------------------------------------------------------------------------------------------------------------------
------------------------------------------------------------------------------------------------------------------------------------------------------
------------------------------------------------------------------------------------------------------------------------------------------------------
S-----SSSS------------------------------SSSSSSSSSS-oo-------SSSSSSSSSSSSSSSSSSSSSSSSSSSSSL------------------------------------------------------------
S---------------------------------------SSSSSSSS--%%%%------SSSS--SSSS------SSSS----------------------------------------------------------------------
S---------------------------------------SSSCSSSS---||-------SSSS--SSSS---g--SSSS----------------------------------------------------------------------
S---------------------------------------SSSSSSSS---||---------SS---S----SS----------oooooo------------------------------------------------------------
S--------------------------------------------------||--SSS----SS---S----SS--------------------------oo----------oooo----------------------------------
S--------------------------------------------------||---------SS---S----SS----------SSSSSS------------------------------------------------------------
S------------------------------------------ggg-----||-------ooSS---SoU--SC--g-g-----SSSSSS------------------------------SS-?Q-------------------------
S---------------------------------------SSSSSSSS---||-------SSSS---SSS--SS--SSSS----------------TT-----------TT-----------------------------#---------
S--------------------------------------TSSSSSSSS---||-------------------------------------------TT-----------TT----------------------TT-----##--------
S--------------------------------------TSSSSSSSS--%||-------------------------------------------TT-----------TT----------------y-----TT-----###------#
S---------k---ggg--------ggg---------kkTSSSSSSSS---||-------k--g-g--------------------------k---TT--------y--TT---y--------SSSSS-----TT-----####----##
XXXXXXXXXXXXXXXXXXXXXXXXXXXXXXXXXXXXXXXXXXXXXXXXXX-||-------XXXXXXXXXXXXXXXXXXXX---XXXXXXXXXXXXXXXXXXXXXXXXXXXXXXXXXXXXX-------XX-XXXXXXXXXXXXXXXXXXXX
XXXXXXXXXXXXXXXXXXXXXXXXXXXXXXXXXXXXXXXXXXXXXXXXXX-||-------XXXXXXXXXXXXXXXXXXXX---XXXXXXXXXXXXXXXXXXXXXXXXXXXXXXXXXXXXX-------XX-XXXXXXXXXXXXXXXXXXXX
