------------------------------------------------------------------------------------------------------------------------------------------------------
------------------------------------------------------------------------------------------------------------------------------------------------------
------------------------------------------------------------------------------------------------------------------------------------------------------
------------------------------------------------------------------------------------------------------------------------------------------------------
------------------------------------------------------------------------------------------------------------------------------------------------------
------------------------------------------------------------------------------------------------------------------------------------------------------
------------------------------------------------------------------------------------------------------------------------------------------------------
------------------------------------------------------------------------------------------------------------------------------------------------------
--------------------------------------------------------------rr---------------------------------------------------y----------------------------------
-----tt---------yy----------------------------------tt----CLCCLC----------------------------------------------@CS-SC@---------------------------------
-----tt-----L!@@!L----------------------------S-----tt------------------------------------------------------------------------------------------------
-----tt---------------------------------------------tt------------------------------------------------------------------------------------------------
-----tt---------------------------------------------tt----------------------------------------tt----------------------------------------------------F-
-M---tt---------------------------g--------------k--tt---------------------rrr----------rrr---tt------------rr--------------------------------------#-
XXXXXXXXXXXXXXXXXXXXXXXXXXXXXXXXXXXXXXXXX---XXXXXXXXXXXXXXXXXXXXXXXXXXXXXXXX---XXXX-----XXXXXXXXXXXXXXXXXXXXXXXXXXXXXXXXXXXXXXXXXXXXXXXXXXXXXXXX-XXXXX
XXXXXXXXXXXXXXXXXXXXXXXXXXXXXXXXXXXXXXXXX---XXXXXXXXXXXXXXXXXXXXXXXXXXXXXXXX---XXXX-----XXXXXXXXXXXXXXXXXXXXXXXXXXXXXXXXXXXXXXXXXXXXXXXXXXXXXXXX-XXXXX
