------------------------------------------------------------------------------------------------------------------------------------------------------
------------------------------------------------------------------------------------------------------------------------------------------------------
------------------------------------------------------------------------------------------------------------------------------------------------------
------------------------------------------------------------------------------------------------------------------------------------------------------
------------------------------------------------------------------------------------------------------------------------------------------------------
------------------------------------------------------------------------------------------------------------------------------------------------------
------------------------------------------------------------------------------------------------------------------------------------------------------
------------------------------------------------------------------------------------------------------------------------------------------------------
------------------------------------------------------------------------------------------------------------------------------------------------------
------------------------------------------------------------------------------------------------------------------------------------------------------
-------------------------------------------------------------------------------------------------------------------------------------S-S--------------
---tt-----------------------------------------------------------------------tt--------------------------------------------------tt--------------------
---tt---------------------------------------------------------tt------------tt--------------------------------------------------tt------------------F-
-M-tt-yyy--------------------------------------------------g--tt----yyy--yy-tt-----yyy------------------------------------------tt-------k----------#-
XXXXXXXXXXXXXXX---XXXXXXX----XXXXXXXXXXXXXXXXXXXXXXXXX----XXXXXXXXXXX---XXXXXXXXXXXXXX-----XXXXX---XXXXXXXXX---XXXXXXXXXX----XXXXXXXXXXXXXXXX----XXXXX
XXXXXXXXXXXXXXX---XXXXXXX----XXXXXXXXXXXXXXXXXXXXXXXXX----XXXXXXXXXXX---XXXXXXXXXXXXXX-----XXXXX---XXXXXXXXX---XXXXXXXXXX----XXXXXXXXXXXXXXXX----XXXXX
