------------------------------------------------------------------------------------------------------------------------------------------------------
------------------------------------------------------------------------------------------------------------------------------------------------------
------------------------------------------------------------------------------------------------------------------------------------------------------
------------------------------------------------------------------------------------------------------------------------------------------------------
-----------o--------U---U-----------------------C---------o------2----1--------------------2--------------2--------------U------------------U---------
-----------------U-------------------------2---------!--------------------------------L--------------------------!-----------o-----------------------U
--@----U---------------------------------@----------------------------------------------@------------C----C--------!-----------------------------U----
---------------------------!--------------------------------------------------------U--@---------------------------------1C-----------@---------------
---@--------------------------------------------------------------------------------------L-----L-----------------------------------------!-----------
---------1----C------!----------------------------------C------------------!----@!------------------------------------------@-------------------------
-----------!-------------------------C-----------------------------!--------------1------------------------L-------U-------------------------@--------
------------k#------#--g-----------Rr---K----#-#---------------#-#Rg-----##---------G------##--g---------y#---R-#-----------#-#------ky-#-----r--#----
--##--#-----#Gr-----K-------------#---K----r#r----#--Y---------G#--y---Y--------K--------------R---gr--#------y---#-#-------y-R#--#G---R------------G-
#M--#G#---------g-----------------------R-#-#-----#------R--#-------##-#-g-#-----------Y-----#-------k---g--#---------##-R----#-----r--R---#y-------F-
XXX-----------X-X--XXX---X------X--XXXX-----X---XX---XX------XXX-X--XXX-XXX-X---XX-X---XXX-X----X-XX-XX-XXX-X-----X-XXX---XX----------X-XX-----X-XXXX-
XXXX-------X-XX-XX-----X---------X--X-X------X---X---X----X----X--X-X-XX-X-X--X-X----XX-X-----X---XXXXX---X------XX---X-XX-X---X-XX-X-XXX---X-----XXXX
