------------------------------------------------------------------------------------------------------------------------------------------------------
------------------------------------------------------------------------------------------------------------------------------------------------------
------------------------------------------------------------------------------------------------------------------------------------------------------
------------------------------------------------------------------------------------------------------------------------------------------------------
-------------U-------L---------------------------1-----------------C------1---------2o-------------------------C---------C----------------------------
---------------------------------------2--------------------!-------1----------o-----------o---------L---1--@-----------------------------------------
---L-----------------------!-------------------------------------------!------L--------------------------@--------------------------------1-----------
---L-----------------C--------o---------------------o-----L-----------------------C------------1-L----@---------------------------------2-----------o-
----C------------------------------o----------o-------!----------------2-----------------2---1-----------------------------------------------------U--
-----------------------------o---------C---C-----------o--------!-----------------------------@-------------------------------------------------------
-----------U--U--@------------U------------------------o--------U!------------------------------------------------------------------------------------
-------Y-G-------#---------G-G##-#-------Y-#---K-R----------r--#GY-----#-#---K------#----------#--#-------g---#--------------------#----#-------------
---k-K--g---------r--#-------y-----Y-#-y----#--k-K--#----#------#r--------------g-#-k--g----#-----------Y-r-----#---#-----#-#-#-g---##----GG---#----rk
RM-----r--#---#-------K#-#------Y----#--y#---##-------y---#---r-------------#----#--k#----g------#Y-----#G---------#--------g-k-----K---K----k------F-
XXX---X-XXX-----X---X-XX-X--------XX-XXX--XXXX---X---X-XXX-X-----X-------XX---X---XX-X-------X---XX-XXXXXX-----XX-X--------X-------X--XX----XX-X-XXXX-
XXX------X-XXXX--X----XX---X-----XXX-----X-X-----X----XXX-XX-XX------XXXXXXXXX--X-XXXX-X--XXX-X---X----XX--X-XX----X-X---X---------X-X-------X-XXXXXXX
