------------------------------------------------------------------------------------------------------------------------------------------------------
------------------------------------------------------------------------------------------------------------------------------------------------------
------------------------------------------------------------------------------------------------------------------------------------------------------
------------------------------------------------------------------------------------------------------------------------------------------------------
-@----------------------------o----------------U-------o----------C-----------------------------------------------------!----------------!--@---------
-----L----2----!C---1-----------------------------------o---L-------------------------------L-----------------!-----------------L--------------!------
--U----@------------------U---o---------------------------------------------------------------------L---UC-o----------U--------@--o------------C------
----------------------------------------------C---------------------------o---------C-----L-----------------------1----------1----U-------------------
---------------------------------2-----------------------1---------o----------------------------------o-----------------------L--------------------@--
L---@---U----------------------------@-----------------U----------------------------------------------------------------------1-----2-----------------
-------------L------C-----U---1-------1-----------L-------------C-------------------!-@----------------!------------------@------------------21-------
-#---#--#--#------k----------R---R-#--#----------#---K--gg------#-----#------------#--r-#----------#------#--#g-#-------G----#---##k---G--g--r-----Y--
--#----------------------R---##---#-g-y---#-------#----K---KyK#-#--#-----#y-##r-------------------R-Yr-R-------#------g--#--------#-K---#-#-----y-----
-M-----K---------#-#--Y#----#---k---R--k---------r-----y---------------g-Y-----------##--#------#--------#--####--#--------#-#-------k---#----------F-
XXXX-X-X------XXXX--XX-X--XXX--XXXX-XXXX--X--X-XX--XX-----X-XX-X----X--X-----XXXX-XXX-X--XXXX--X-----X-XXX--XXXXX-X-X--XXX--XXX------X---XXX--XXX-XXXX
XXX--X-XXX-XXX-X-----XX----X--X--------X--XX-X-X----XX---X-XX----XXXX-XXXXX------XX-XXXX-X------XX---XXX--X-X----X--X--X---X----XXX---XX---X-X-XXXXXXX
