------------------------------------------------------------------------------------------------------------------------------------------------------
------------------------------------------------------------------------------------------------------------------------------------------------------
------------------------------------------------------------------------------------------------------------------------------------------------------
------------------------------------------------------------------------------------------------------------------------------------------------------
-----------------------------1--------------o-----------C------------------------C--C--------------L--------------------------------------------------
--------------------------2-----------------------------------------------@-----C-----------------U--L--------------@---------------------------------
------------------!-------L----------------------------------------------Co----------------@------------L---------------------1--o---------U----------
C!---@1------C@-----------------------o-------------U--------------!------------------!--------------------------------------------------o------------
--------------------------o--------@-------------o---------1--------U----------U-------------------------------1--------------------------------------
------------------------------1-----------------------------------------------------------------U----------------------------!-----------------------1
---------@---------------L--------L-----------------------------------------L------U-----------------------------U--------------------o---------------
--YK----#--#-------------------------------------#----#-----#-R-----#----------------r------------##-#---------y---###Y-K---------#---------#--K------
----------------#-------g--------------#--G--------#--------------#------##------#-----Y-------Y--#--r-------r------KK--##---R-#-R----RR----r----K##r-
RM--R-----------#-#---K----G-#-------K#----------G----KG---#-----#----K----------------k----------K-y----K---#----#-----r---#--g------R#-------Y----F#
XXX----X-X-X--X----X----X--XX---X--XX-X--XXX-X----XXX-XX-----XXX-X-XX--X------X---X-XX-------XXXX-X--X--X----X--XX-X-----X---X--X---------X-XXXXXXXXXX
XXX--XX-XXX-X--XX--X--XX----X-X--XX-XXXXXX--X-X-XX-X-X----X-----XX-XX----X-----------X---------X-XXX---X--X-----X-XX-XX--X-XXXXX-XXXX--XX-----XX--XXX-
