------------------------------------------------------------------------------------------------------------------------------------------------------
------------------------------------------------------------------------------------------------------------------------------------------------------
------------------------------------------------------------------------------------------------------------------------------------------------------
------------------------------------------------------------------------------------------------------------------------------------------------------
----------------------------------------------------2--L--------2-----L----------------@----L--C---------------L--!--------------------C--U---!----U--
------1------------o-o--------------U----------------------------------------!-----------------------L------------------------------------------------
U1----@------------1----------------------2--------------------------------------------------------------U--------o---------U-----C----------@--------
------1-----------------U---------------------------------------U-o-----------------------------------------------------------------C1---------------L
-C----------------------------------------------U-----Uo----U---------------------------------!-------------1-----------------U-----------------------
------U---------------------------------------2----C-----------@-----L-----oo------------------!-L-----------L-------@----------o---------------------
----------------------2------------------------------------------------------------------------------U------1---@-------------------------------------
-y-#----#----------G-K-------k--#----#---------------#----##--#--#R--------y----R-----#-------#-##---#-y-#r--#--------------r--------------Y-#-g#K----
##----##--##K--#k--y-------------R------#--#----#-##--K--#-------#---G--#---r-G--#-r#---G---r------r----------#----#-----R-----#---#-----##-----G-#--Y
-M------------K-#-----#-----#---#-----K--#R----------k-k----#--------##--k-----------#---#----------r#------#-----------R----#-----K--R--GYy--#--y--F-
XXX-XX--XX-X--X-X--X-X--X---X-X-XX--X--------X-X----X----XXXX--XXXX----XXX--X-X-X--XX-X---X--X--X-XX---X--XX-XXXX--X-XXXX--X-X-----XXXX-XXX--XXXX-XXXX
XXX-X-X-X-XXXX-XXX----X-XX----XX-X-X-X---XX--X------X--X--X----X-X-XXX----X-X-X-XX---X----X------X-XX--XXXX--XX---X-XXX--XXXXXX--XX------X-------XXXX-
