--------------------------------------------------------------------------------------------------------------------------------------------------------------------------------------------------------------
--------------------------------------------------------------------------------------------------------------------------------------------------------------------------------------------------------------
--------------------------------------------------------------------------------------------------------------------------------------------------------------------------------------------------------------
-----------------------U-----------------------------------------U---------------------------------------------U----------------------------------------------------------------------------------------------
------------------------U-----------------------------------------U---------------------------------------------U---------------------------------------------------------------------------------------------
-------------------------U-----------------------------------------U---------------------------------------------U--------------------------------------------------------------------------------------------
--------------------------U-----------------------------------------U---------------------------------------------U-------------------------------------------------------------------------------------------
---------------------------U#############----------------------------U############---------------------------------U############------------------------------------------------------------------------------
----------------------------U------------#----------------------------U-----------#---------------------------------U-----------#-----------------------------------------------------------------------------
-----------------------------UUUUUUUUUUU-#SSS#-------------------------UUUUUUUUUU-###S#------------------------------UUUUUUUUUU-###S#-------------------------------------------------------------------------
---------------------------------------------D----------------------------------------#---------------------------------------------#-------------------------------------------------------------------------
----------------------------------S----------D-----------------------------S----------#-----------------------------------S---------#-------------------------------------------------------------------------
--M-------------------------------SSSSSS-----D--------------------#ggggggg-SSSSS------#----------------------#ggggggggggg-SSSSS-----#-------------------------------------------------------------------------
XXXXXXXXXXXXXXXXXXXXXXXXXXXXXXXXXXXXXXXXXXXXXXXXXXXXXXXXXXXXXXXXXXXXXXXXXXXXXXXXXXXXXXXXXXXXXXXXXXXXXXXXXXXXXXXXXXXXXXXXXXXXXXXXXXXXXXXXXXXXXXXXXXXXXXXXXXXXXXXXXXXXXXXXXXXXXXXXXXXXXXXXXXXXXXXXXXXXXXXXXXXXXX
XXXXXXXXXXXXXXXXXXXXXXXXXXXXXXXXXXXXXXXXXXXXXXXXXXXXXXXXXXXXXXXXXXXXXXXXXXXXXXXXXXXXXXXXXXXXXXXXXXXXXXXXXXXXXXXXXXXXXXXXXXXXXXXXXXXXXXXXXXXXXXXXXXXXXXXXXXXXXXXXXXXXXXXXXXXXXXXXXXXXXXXXXXXXXXXXXXXXXXXXXXXXXX
XXXXXXXXXXXXXXXXXXXXXXXXXXXXXXXXXXXXXXXXXXXXXXXXXXXXXXXXXXXXXXXXXXXXXXXXXXXXXXXXXXXXXXXXXXXXXXXXXXXXXXXXXXXXXXXXXXXXXXXXXXXXXXXXXXXXXXXXXXXXXXXXXXXXXXXXXXXXXXXXXXXXXXXXXXXXXXXXXXXXXXXXXXXXXXXXXXXXXXXXXXXXXX

