-------------------o-----------------------------------------------o--------------------------------------------------------------o-------------------
-----o---------------------------------------------------------------o-------------------------------------------o------------------o---o-------------
---------------------------------------------------------------------o----------------------------o-o-------------------------------------------------
-------------------------o---o--------o----------------------------------------o-----------o----------------------------------------------------------
----------------------------------------------------------o------o--o--------------oo-----------------------------------------------------------------
------------------o--------------------------o-----------------o----------------------------------------------------------------------o---------------
-------------------o------------o--------------------------------------------------o----------------------------o-------------------------------------
-----------o-----oo--------o------------------------------------o-------ooooo-g-------------------------------g----------------oo2-----------o--------
-------------oCCo--------o---------------------------------ooC----------------2oCo-------ooo-oooo-------------2ooooo2ooo--o22C----------------o-------
-----------------*---------------------o---------------Coo------------------------g----------------Coo--------------------o--------2oo----------------
--o--------------*----o------------C222Ckooog---g------------o----oo2o----------XXX-o2o----rg------------ooC------------*------------------r----------
-----------------*oooCo---o2ooo------XXXXXXXX-ooC-------------------------------XXX--------tt----------------o----------*------------------tt---------
-M------rk-------*r-g---gr-----r-k---XXXXXXXX--k--kk-k-------r-k-g-g-r--k-g---g-XXX-------gtt----g-----g-g-g---r--kg----*-g-----g----g--g--tt---g---F-
XXXXXXXXXXXXXXXXXXXXXXXXXXXXXXXXXXXXXXXXXXXXXXXXXXXXXXXXXXXXXXXXXXXXXXXXXXXXXXXXXXXXXXXXXXXXXXXXXXXX--XXXXXXXXXXXXXXXXXXXXXXXXXXXXXXXXXXXXXXXXXXXXXXXX
XXXXXXXXXXXXXXXXXXXXXXXXXXXXXXXXXXXXXXXXXXXXXXXXXXXXXXXXXXXXXXXXXXXXXXXXXXXXXXXXXXXXXXXXXXXXXXXXXXXX--XXXXXXXXXXXXXXXXXXXXXXXXXXXXXXXXXXXXXXXXXXXXXXXX
XXXXXXXXXXXXXXXXXXXXXXXXXXXXXXXXXXXXXXXXXXXXXXXXXXXXXXXXXXXXXXXXXXXXXXXXXXXXXXXXXXXXXXXXXXXXXXXXXXXX--XXXXXXXXXXXXXXXXXXXXXXXXXXXXXXXXXXXXXXXXXXXXXXXX
