----------------------------------------o-----o-------------------------------------------------------------------------------------------------------
-----------------------------------------------------o------------------------------------------------------------------------------------------------
------------------------------------------------------------------------------------------------------------------------------------------------------
--------------------------------------o---------------------------------------------------------------------------------------------------------------
------------------------------------------------------------------------------------------------------------------------------------------------------
------------------------------------------------------------------------------------------------------------------------------------------------------
-----------------------------------------g-----------------------------------------------g------------------------------------------------------------
-----------------------2oo----------o---oCC------------2o22C--------2oCoo---------------o222C----------o--------------------CCo-o2oC------------------
---------------------------------------------------------------------------ooCCo-----g--------------------r----------o2oC2----------------------------
---------------------o------ooCo-CCo------------CCCCo----------oCo----------------o22C--------------------tt---------------------------ooo------------
------------oCC--g----------g-XXXXXXXo-----------------XXXX-----------------------XXXXX-------------------tt------------------------------------------
----------------o2oo------XXXXXXXXXXX------------------XXXX------tt---------------XXXXX----------oC2o2XXooot--2ooo2-----------------------------------
-M---------r-k--g--ggg---kXXXXXXXXXXX-kkr-r-k-------kg-XXXX---g--tt--k-r----------XXXXX------------XXXXX--tt-------r--k--------g---k--g----g--------F-
XXXXXXXXXXXXXXXXXXXXXXXXXXXXXXXXXXXXXXXXXXXXXXXX-XXXXXXXXXXXXXXXXXXXXXXXXX--XXXXXXXXXXXXXXXXXXXXXXXXXXXXXXXXXXXX---XXXXXXXXXXXXXXXXXXXXXXX-XXXXXXXXXXX
XXXXXXXXXXXXXXXXXXXXXXXXXXXXXXXXXXXXXXXXXXXXXXXX-XXXXXXXXXXXXXXXXXXXXXXXXX--XXXXXXXXXXXXXXXXXXXXXXXXXXXXXXXXXXXX---XXXXXXXXXXXXXXXXXXXXXXX-XXXXXXXXXXX
XXXXXXXXXXXXXXXXXXXXXXXXXXXXXXXXXXXXXXXXXXXXXXXX-XXXXXXXXXXXXXXXXXXXXXXXXX--XXXXXXXXXXXXXXXXXXXXXXXXXXXXXXXXXXXX---XXXXXXXXXXXXXXXXXXXXXXX-XXXXXXXXXXX
