-----o-----------o-----------------------------------------o---------o--------------------o-----------------------o--o--------o-o-----o------------o--
----------o-----------o----o--------o------------------------o----------o----------oo----------------o--o---o-------------o------------o---o----------
--------o-------------------o----------o----------------o-----o----------------o--------------o---------------------o-----------------------------o---
--o-------o---------o--------o---------o----o---------o------------------oo---------o-----------o--------------------o------------o-------------------
-------------------------o----------------------o-------------------------o------------------------------------------------------------------o--o-----
--o--------------------------------o-------------o-------o------------------o-o---------------o----------o---o-------oo------------------o-o----------
-----------------o-o-o-----o------oo------o-----------o-----------o-------o-------------------o--o---------oo--------o---------o----------------------
----------ooo2-----------2o2o2--------o-oCo-o---------g---Cooo2-------ooooC-----------o----o-----------o----------o-------o---------------------------
-------------------------o--o-----kg---------o----ooo-C2o---------o--------o-----ooooo--------2ooC--------o---ooo-------------CoC---------------------
------o--------oo---------o---o*--tt--------ooCo-o-------------o---o----o---ooC-o---g--oo-----g------------o2o2--2oo-o--o------------o----------------
---o----o-o-o--ooooo-----o-----*--tt-----o--------tt------------2ooo-*o--g------o--XXX--ooooo-XXXXXXXo----------kg---2ooo-----------o-o2ooo-o--o------
-----o-o-----o----tt-o--o------*--tt------o-------tt--------------ooo*--tt------oo-XXXXXXXXX-oXXXXXoCooCXXXX---XXXX-----o-XXXXXXXXXX-----o--o--ooo----
-M--g------g-----gtt--r--k----g*-ktt--------k---g-tt------rgro-gk---k*--tt----gg-g-XXXXXXXXX--XXXXXXXXXXXXXX-k-XXXX-g--r--XXXXXXXXXX----rgggrg-gk---Fk
XXXXXXXXXXXXXXXXXXXXXXX-oXXXXXXX-XXXXXXXXXXXXXX-XXXXXXXXXXXXX--XXXXXXXXXXXX-o-XXXXXXXXXXXXXX-oXXXXXXXXXXXXXXXXXXXXXXXXXXXXXXXXXXXXXXXXXXXXXXXXXXXXXXXX
XXXXXXXXXXXXXXXXXXXXXXX--XXXXXXX-XXXXXXXXXXXXXX-XXXXXXXXXXXXX--XXXXXXXXXXXX---XXXXXXXXXXXXXX--XXXXXXXXXXXXXXXXXXXXXXXXXXXXXXXXXXXXXXXXXXXXXXXXXXXXXXXX
XXXXXXXXXXXXXXXXXXXXXXX--XXXXXXX-XXXXXXXXXXXXXX-XXXXXXXXXXXXX--XXXXXXXXXXXX---XXXXXXXXXXXXXX--XXXXXXXXXXXXXXXXXXXXXXXXXXXXXXXXXXXXXXXXXXXXXXXXXXXXXXXX
