---------o-----------------------o----oo----------------------o-------------------------------------------------------------------o-------------------
---o-----------------o-------------------o------------------------------o----o-------------o-----------------o-------------------oo---o--o----------o-
--------o---o---------o--------o---o--o--------------o---o--------------------------------o----------o---------------o--------o--------o--------------
---------------o-------o---------------o-----------o-------------o---------o---o------------------------------o----o-o--------------------------------
-----------o-----------oo----------------o-----o----------o---------------------------------------------------------------------------------o-------o-
---o-----o-----o-------o------------------------------------------------------------o------------------------o-oo--o--------------o-------------------
-----o---------o--------o---------------o-------o--------o---------o-------------o--o-------o--o-------------o---------------------------o-----------o
-----o-------------o----o-oo2o-----------o-----------------------------oo------o---g-------o-----------2-oo-----------------------------ooo----o------
o-o-----o-g----ooooC-2Co2-----o--o-o---o---o-o-oooooo--o---o---------o----oo2C22--o2o22o----------------o--o---ooo-----o-------------oooo-------------
-----o-o--2oo----ooo-----tt----oo2o-ooCC-o-o---o---------CoC-ooor-----------tt--o-o-o---ooooC--o-o--o-k--k-r2CoCo-o----22o------------gg----------o---
-----o-o-----o----g-g----tt------o-o-o--o--o2oo------oo--tt--XXXXXXXX--o----tt----------o-*---o--oooooXX-XXXX----go--o-oo------CCo----XXX-------------
----o---------o---XXXXXXXtt---o-o-------------o---o------tt--XXXXXXoo2CCXXXXtt----tt-----X*X--------XXXX-XXXXXXXXX2ooooo-o-o-----oo---XXX-----o-------
-M---r---------g--XXXXXXXtt------k---g----r---------gr---tt--XXXXXXXXXXXXXXXtt---kttg-k--X*X---g---gXXXX-XXXXXXXXXXX-kg---------krrkggXXX-kkg-k-----Fk
XXXXXXXXXXXXXXXXXXXXXXXXXXXXXXXXXXXXXXXXXXXXXXXXXXXXXXXXXXXXXXXXXXXXXXXXXXXXXXXXXXXXXXX--XXXXXXXXXXXXXXX-XXXXXXXXXXXXXXXXXXXXXXXXXXXXXXXXXXXXXXXXXXXXX
XXXXXXXXXXXXXXXXXXXXXXXXXXXXXXXXXXXXXXXXXXXXXXXXXXXXXXXXXXXXXXXXXXXXXXXXXXXXXXXXXXXXXXX--XXXXXXXXXXXXXXX-XXXXXXXXXXXXXXXXXXXXXXXXXXXXXXXXXXXXXXXXXXXXX
XXXXXXXXXXXXXXXXXXXXXXXXXXXXXXXXXXXXXXXXXXXXXXXXXXXXXXXXXXXXXXXXXXXXXXXXXXXXXXXXXXXXXXX--XXXXXXXXXXXXXXX-XXXXXXXXXXXXXXXXXXXXXXXXXXXXXXXXXXXXXXXXXXXXX
