--------o-----o-----o-----------------o--------------o-----------o-----o------------o------o-o---------------o----------------------------------------
--------------o-----------o--o---------------------------------------------------------------------------------------------------------------------o--
---------o---------------o-----o---o---------------------------------o----------------------o--------------------------------o------------------------
----o-----------------------o----o------------------------oo---------------------o---------oo------------------------o-----------oo------o--o---------
--------------------------o-------------------------------o----------------------------------------------------------------------------------------o--
-------o--o-------------o-------------o----------------------------o-----------o------o-----------------------------------------------------------o---
----o--------o-----o--o---o------------------------o-----o-o----o---o---o---------oo--o-------o---------------------------o------o---------o-o--------
-----------o----------------o-o-ooC---o----------------------------o-------------2-------o---------o-o-------------o---------------o--o--ooCo-------o-
--------o------------oo--------------------2o2-------o------o-------o-----------o----------------oo-----------o---o--------o--------------------o-----
----------oooo--o-ooo-----------g----Coo2-----------o--o------2oC--o---------oo----o-----------oo---------oooo---o2C-goo----g-------------------o--o--
----------o---o--oott-ooCo2o--XXXXXX-------------2o222--oo2oo-----*---g-------o--o----ooo-o-----2oooC----------------2-o-Coo2o-------o-----k--k-------
--------------o----tt----XXXXXXXXXXX---o---tt---tt----------------oCooC--Co2oo---o2o--XXX---o-o------ooo2o-----------o--------o-2oo-ooooXXXXXXX--o----
-M------------g-r--tt----XXXXXXXXXXXggrggr-tt---ttg---rg----k-k-kg*--k--g----kgkkg-r--XXX--------k---g----krkg--kgk-------k----g-gg---XXXXXXXXX-----Fk
XXXXXXXXXXXXXXXXXXXXXXXXXXXXXXXXXXXXXXXXXXXXXXXXXXXXXXXXXXXXXXXXXXXXXXXXXXXXXXXXXXXXXXXXXXXXXXXXXXXXXXXXXXXXXXXXXXXXXX-XXXXXXXXXXXXXXXXXXXXXXXXXXXXXXX
XXXXXXXXXXXXXXXXXXXXXXXXXXXXXXXXXXXXXXXXXXXXXXXXXXXXXXXXXXXXXXXXXXXXXXXXXXXXXXXXXXXXXXXXXXXXXXXXXXXXXXXXXXXXXXXXXXXXXX-XXXXXXXXXXXXXXXXXXXXXXXXXXXXXXX
XXXXXXXXXXXXXXXXXXXXXXXXXXXXXXXXXXXXXXXXXXXXXXXXXXXXXXXXXXXXXXXXXXXXXXXXXXXXXXXXXXXXXXXXXXXXXXXXXXXXXXXXXXXXXXXXXXXXXX-XXXXXXXXXXXXXXXXXXXXXXXXXXXXXXX
