-----------------------------------------------------------------------o------------------------------------------------------------------------------
--------------------------------------------------------------------o-----------o---------------------------------------------------------------------
-----------------------------------------------------------------o--------------------------o---------------------------------------------------------
--------------------------------------------------------------------o----------------------------------------------------------------------o----------
---------------------o---------------------------------o------o-----------------------------------------------------------------------------------o---
--------------------o------------------------------------------------------------------------------o--------------------------------------------------
-------------------------------------------o---------------------------------------------g------------------------------------------------------------
-----------------------------------------o222o---------------------o--------------------o2oo----------------------------o2C22--------ooooo------------
----------------------------CCo-------------------------------------------------------o-------o-------------------------------ooooC---------------o---
----------o222o--------ooC------ooo-----oo--------g-----------------------*--g----------------C2oo---------o2o----------------------------------------
----------------------------XXXX----------------2oCoo*Coo-CoC-------------CCo2o-----tt------------------o--------g--XXXXXXX-------g------ttoooo-------
----------------ooCooC------XXXX---oCooC------------X*XXX-tt--------oooXX-*-----CooCotXXXX---o-----2oo2--------oCC2oXXXXXXX------XXXXXXXXtt------o----
-M--k------g--r--g---gg----gXXXX-----r---gk------g-gX*XXXrtt-------XXXXXX-*-k-----XXttXXXX-----------g-r---g-k------XXXXXXX------XXXXXXXXttg-k------Fg
XXXXXXXXXX-XXXXXXXXXXXXXXXXXXXXXXXXXXXXXXXXXXXXXXXXXXXXXXXXXXXXXX--XXXXXXXXXXXXXXXXXXXXXXX---XXXXXXXXXXXXXXXXXXXXXXXXXXXXXXXXXXXXXXXXXXXXXXXXXXXXXXXXX
XXXXXXXXXX-XXXXXXXXXXXXXXXXXXXXXXXXXXXXXXXXXXXXXXXXXXXXXXXXXXXXXX--XXXXXXXXXXXXXXXXXXXXXXX---XXXXXXXXXXXXXXXXXXXXXXXXXXXXXXXXXXXXXXXXXXXXXXXXXXXXXXXXX
XXXXXXXXXX-XXXXXXXXXXXXXXXXXXXXXXXXXXXXXXXXXXXXXXXXXXXXXXXXXXXXXX--XXXXXXXXXXXXXXXXXXXXXXX---XXXXXXXXXXXXXXXXXXXXXXXXXXXXXXXXXXXXXXXXXXXXXXXXXXXXXXXXX
