------------------------------------------------------------------------------------------------------------------------------------------------------
------------------------------------------------------------------------------------------------------------------------------------------------------
------------------------------------------------------------------------------------------------------------------------------------------------------
---------------------------------o--------------------------------------------------------------------------------------------------------------------
---------------------------------o-----------------------------o--------------------------------------------------------------oo--------------o-------
------------------------------------------------------------------------------------------------------------------------------------------------------
----------------------------------------------------g-------------------------------------------------------------------------------------------------
--------------------------------CCooo-----2oCC--ooo2C------------------------oo------------g-----------------------------------------o----o-----------
-----------------------------------------------------------------------g-------------------Coo--Coo---------------------------------------------------
----------Coo------*--------------------------g---------Coo---CCo22-oooC2----------------------------------g---CCo2------CoC-----------g--------------
-------------------*ooo---ooooC-------o2C-XXXXXXXXXXX-------------------g--o2-----ooo----tt---------------oCo------rooo2--------------CCC2------------
--------o----------*----------------------XXXXXXXXXXX-----------XXXXXXXXXXXttXXXXXX----oootX--------oooC2--o-----XXX-*------o-Cooo2----tt-------------
-M------------gk--k*-g--g-g-----rg------g-XXXXXXXXXXX--k--------XXXXXXXXXXXttXXXXXX-kr--XttX--r---------------k-gXXX-*g--gr-----r--g---tt-----------F-
XXXXXXXXXXXXXXXXXXXXXXXXXXXXXXXXXXXXXXXXXXXXXXXXXXXXXXXXXXXXXXXXXXXXXXXXXXXXXXXXXXXXXXXXXXXXXXXXXXXX-XXXXXXXXXXXXXXXXXXXXXXXXXXXXXXXXXXXXXXXXXXXXXXXXX
XXXXXXXXXXXXXXXXXXXXXXXXXXXXXXXXXXXXXXXXXXXXXXXXXXXXXXXXXXXXXXXXXXXXXXXXXXXXXXXXXXXXXXXXXXXXXXXXXXXX-XXXXXXXXXXXXXXXXXXXXXXXXXXXXXXXXXXXXXXXXXXXXXXXXX
XXXXXXXXXXXXXXXXXXXXXXXXXXXXXXXXXXXXXXXXXXXXXXXXXXXXXXXXXXXXXXXXXXXXXXXXXXXXXXXXXXXXXXXXXXXXXXXXXXXX-XXXXXXXXXXXXXXXXXXXXXXXXXXXXXXXXXXXXXXXXXXXXXXXXX
