------o-------o--o-------o------------------oo---------------------------o----o---------------o---o---o-----------------------------------------------
---o-------------------------o----------o-o----------------------------------------------------------------------------------------ooo-----o--o-------
------------------o--------o----o----------------------------------o----------------o----o-------------o----------o---o-------------------------------
--------o-----o----------------------------------o--o----o-----------------------------o----------o--------oo--o----------------------o------o--------
------o--oo---o-------------------------------------o------------------o---------------------------o-------------o--------------o--------oo-----------
--o------------------o--------o-----------------o-------------------------o-------o----------------------------------------------o--------------------
-----------oo-o----------------------------o--o-o------------oo-------------------o--------------------oo--------o----------o------------oo-----------
-----------------------oooooo-----------------o2o----------o----------------------------------o----------------------o----------o--------oo-----------
--o-oo-o-----------o-------o--g--------------------------ooCo---------------------oo-----o--o----------------------o-------------ooo2ooCoCo-----------
----------------o--o-----k----2oo2-oo22-----o-o-oo-o----------------o-----o----------o--o-----------------o-o--------oCoo----o-------g-----o---o-o----
--o--------oo--o-oooCC--XXXXXXX-tt------o--g----o-oo2oo----------oCooo-o2o2o-------XX------o---oooC-----oo-------22o--o-------o--oottXX--o---o----o-o-
----o-----o-o-----------XXXXXXX-tt-o-o--ooo22XX---o---o----------------o------oooo-XX--oo2ooXXX-o---Coo----ooooC----------ooooo-o--ttXX---------------
-M-rg---k----k----r-kk-gXXXXXXX-ttg---g-----XXXgr------k-------k-ggrk--g-rgk-----ggXX--gkgXXXXX-g-----krr-k-g--gr---k-g--kggg----g-ttXX-r-k---rr----Fk
XXXXXXXXXXXXXXXXXXXoXXXXXXXXXXXXXXXXXXXXXXXXXXXXXXXXXXXXXXXXXXXX-XXXX--XXXXXXXXXXXXXXXXXXXXXXXXXXXXXXXXXXXXXXXXXXXXXXXX--XXXXXXXXXXXXXXXXXXXXXXXXXXXXX
XXXXXXXXXXXXXXXXXXX-XXXXXXXXXXXXXXXXXXXXXXXXXXXXXXXXXXXXXXXXXXXX-XXXX--XXXXXXXXXXXXXXXXXXXXXXXXXXXXXXXXXXXXXXXXXXXXXXXX--XXXXXXXXXXXXXXXXXXXXXXXXXXXXX
XXXXXXXXXXXXXXXXXXX-XXXXXXXXXXXXXXXXXXXXXXXXXXXXXXXXXXXXXXXXXXXX-XXXX--XXXXXXXXXXXXXXXXXXXXXXXXXXXXXXXXXXXXXXXXXXXXXXXX--XXXXXXXXXXXXXXXXXXXXXXXXXXXXX
