---------------------------------------------------o--------------------o---------------------------------------------o---o---------------------------
-------------------------------------------------------o----------------------------------------------o----------oo-----------------o-----------------
----o-------------------------------------------------------o------------------------------------------------------------------o----------------------
-----o------o----------------------------o------------o-----------------o-----------------------------------------------------------------------------
------------o------------------o--------------------------------o-----------------------------------o--------------o---------------o------------------
------------------------------------o------------------------------------o---------------o----------------------------------------o-------------------
-o--------oo-----------------------o-o---o-----------o------------------------------------------------------------------------------------------------
----------------------------------------------------2ooo----------------oooC---------------------------------o--------g----------------o---------o----
-----------------------o-------------2ooo--------o--------------------oo-------------o---------------o------o---ooCo-CCoC-----------oo22o-------------
-------o--oCo-oooC--oCCo-oooo----o2C----------------------------------------------22oo-ooo----tt--tt----o---*----tt------g----------------*--------o--
------o--------XXXXXXXXXX------------*---C2o-------------g---oooooo-----o-*----o----XXX-----g-tt--ttXo22-oC22o---tt-----tt----------------*XXXX-------
--------------oXXXXXXXXXX-o----------*---------------XXXXXX---------------*--oo2----XXX-----XXttXXttXXXX----*-o-XttX----tt--Cooo----------2CooX-------
-M-g------g----XXXXXXXXXX---kr------g*r----k-grr-kgg-XXXXXXr-g-----g-----r*gg--kk--kXXX---g-XXttXXttXXXXkr--*g--XttX----ttk-g---g-----g-g-*XXXX--g--Fg
XXXXXXXXXXXXXXXXXXXXXXXXX--XXXXXXXXXXXXXXXXXXXXXXXXXXXXXXXXXXXXXXXXXXXXXXXXXXXXXXXXXXXX--XXXXXXXXXXXXXXXXXXXXXXXXXXXXXXXXXXXXXXXXXXXXXXXXXXXXXXXXXXXXX
XXXXXXXXXXXXXXXXXXXXXXXXX--XXXXXXXXXXXXXXXXXXXXXXXXXXXXXXXXXXXXXXXXXXXXXXXXXXXXXXXXXXXX--XXXXXXXXXXXXXXXXXXXXXXXXXXXXXXXXXXXXXXXXXXXXXXXXXXXXXXXXXXXXX
XXXXXXXXXXXXXXXXXXXXXXXXX--XXXXXXXXXXXXXXXXXXXXXXXXXXXXXXXXXXXXXXXXXXXXXXXXXXXXXXXXXXXX--XXXXXXXXXXXXXXXXXXXXXXXXXXXXXXXXXXXXXXXXXXXXXXXXXXXXXXXXXXXXX
