--------------o--------------------o--------------------------------------------------o----------------o-----o--------------oo------------------------
-o-o----------------------o-------o---------------------------o---------------o---------------------------o----o------------o-----------o-------------
------o--------------------------------------o---------------o-----------o------o-----------------o-----------------o------o------o----------------o--
------o-o-----o----o-----------------------------o---------------o----o--------oo---o---------------o-----------------o----o-o----------o-------------
------------o-----------------------------------------o-------o---------o----o-------------oo-------------------------------------------o-----oo------
-----------------------o--o-------o----------o--------------------------------------------o---------o--------------------------------------o-o--------
--o--------------------o---o-o-------o-----------o---------o----------o---------o--o------------------------------og------------------------------o---
-----------------------------------o---o--------------o---o-----------------o--o-----------g-------o-------2oCo--Co2----------------------------------
-----o-----o-o-------oooo-----o--o-------------------------o------------------------------C2---------------oo-o---------------------------o-oo--------
-----------------ooo--------o---k-g--oo------------o----o--oooo---o-o-og--o-o2ooo-o-o---o-o----o---o-o-------o------o--o--oo---ooo----o--o22-o----o-o-
--------------------XX-o--Co2oooXXXX---o-----o-------Xo2ooXXXXXXoo----22oo--------ooooooo---2o-o2CCo-o------------oo----o--o----o--o-----o------------
-----------o2o------XX-----*----XXXoooo2oo-----o-----XXXXXXXXXXXCo2oo-o-----------oooo----o----o-Xtt--2CCo---------o---o-ooo-------o-ooC---------oo---
-M---r----g--g---g--XX-----*----XXXX--r-g-----g------XXXXXXXXXXX----rggrkgg-gg---k---k----k-----gXtt----g---g--gg---g-----k--r--g----k-g-----r------Fk
XXXXXXXXXXXXXXXXXXXXXXXXXXXXXXXXXXXXXXXXXXXXXXXXXXXXXXXXXXXXXXXXXXXXXXXXXXX-XXXXXXXXXXXXXXXXXXXXXXXXXXXXXXXXXXXXXXXXXXXXXXXXXXXXXXXXXXXXXXXXXXXXXXXXXX
XXXXXXXXXXXXXXXXXXXXXXXXXXXXXXXXXXXXXXXXXXXXXXXXXXXXXXXXXXXXXXXXXXXXXXXXXXX-XXXXXXXXXXXXXXXXXXXXXXXXXXXXXXXXXXXXXXXXXXXXXXXXXXXXXXXXXXXXXXXXXXXXXXXXXX
XXXXXXXXXXXXXXXXXXXXXXXXXXXXXXXXXXXXXXXXXXXXXXXXXXXXXXXXXXXXXXXXXXXXXXXXXXX-XXXXXXXXXXXXXXXXXXXXXXXXXXXXXXXXXXXXXXXXXXXXXXXXXXXXXXXXXXXXXXXXXXXXXXXXXX
