----------------o-------------------------------------------------------------------------------------------------------------------------------------
-------------------------------------------o----------------------------------------------------------------------------------------------------------
------------------------------------------------------------------------------------------------------------------------------------------------------
---------------------------------------------------------------------------------------------------------------------------------o--------------------
------------------------------------------------------------------------------------------------------------------------------------------------------
------------------------------------------------------------------------------------------------------------------------------------------------------
------------------------------------------------------o-----------------------------------------------------------------------------------------------
-----------oCo-----------g-g-----------------------------------------------------------22C-------------------------C2oo---------------ooo2------------
---------------oo2oo-----C22----------------------------------------------------------------------ooo--------oo2o-------------o22oo-------------------
-----------------------------------------------o--------------g-------Coott---------------------------------------------oCC---------g---tt------------
----------XXXXXX-------------oo2o-o2o-----------ooo----2oooo--CoooC------tt-----oo22o--------ooo------oCCoo--------g------------XXXXXX--tt-oooo-------
------o---XXXXXX-----oCo-XXX----------------ooC--XXXXXX------------------tt2oo-------------------------------XXttXXX-------XXXXXXXXXXXXXttXXXX--------
-M-----g--XXXXXX--g----g-XXXg--------------g---k-XXXXXX-----g----r---g---tt-k--------g---g-----g--ggr------g-XXttXXX---g-g-XXXXXXXXXXXXXttXXXX------F-
XXXXXXXXXXXXXXXX--XXXXXXXXXXXXXXXXXXX-XXXXXXXXXXXXXXXXXXXXXXXXXXXXXXXXXXXXXXXXXXXXXXXXXXXXX--XXXXXXXXX----XXXXXXXXXXXXXXXXXXXXXXXXXXXXXXXXXXXXXXXXXXXX
XXXXXXXXXXXXXXXX--XXXXXXXXXXXXXXXXXXX-XXXXXXXXXXXXXXXXXXXXXXXXXXXXXXXXXXXXXXXXXXXXXXXXXXXXX--XXXXXXXXX----XXXXXXXXXXXXXXXXXXXXXXXXXXXXXXXXXXXXXXXXXXXX
XXXXXXXXXXXXXXXX--XXXXXXXXXXXXXXXXXXX-XXXXXXXXXXXXXXXXXXXXXXXXXXXXXXXXXXXXXXXXXXXXXXXXXXXXX--XXXXXXXXX----XXXXXXXXXXXXXXXXXXXXXXXXXXXXXXXXXXXXXXXXXXXX
