----o------------o--------------------------o--------------o----------------------------o------------------o--o--------------o----------------------o-
-----o--o----------o-------------------o---o-----o-----o-----------------o--------------o-------------o--o---------------o----------o-o---o-----------
o-oo------o--------------------o-------o------------------o------o-------o------o----------------------o-----------------o------------------oo--------
--------------o-------------------------o--o-------------------o---------------------------------o------------o---o------------------------o----------
--o-------------------------------------------------------o--o------o----o---------o--------o---o----------------------------------o------o-----------
----------------o--------------o----------------------------------------------------------o------------------------------o--------------o--o----------
----o-------------o-------------------------------------------o-----o----------------o-o----------o------------------o-o--o---------------------------
----------o-o----------------o------o---o2ooo---g----------------o--o------2o22o-----o-------o--Cooo----------o---o-------o-2oo----ooo-o--------------
-o--------ooo-o-------o-----------oo-oo----o---C2oo2----o-----------------o----------------o----o-----o-o----------Co2o-ooo-o--------------------o----
--o------o-------o--o--oo-------o-o-22o--o------------o--o-o2o--o------o-------o--o----g*-----o--o----2Coo*----oo--o-----g--r----o--------oooo---o----
-o---------k---2oo2o-oCoC------o---o-gkg-----------oo----o---o----o---o--o---o---o---XXX*-o---o-------o---*--o--oo--o-XXXXXXtt--o----------oo---o--o--
-----o----tt--------------o2ooo--o--XXXX--------------Coo---o-------o--Co2-tto--o2o2-2oo*-ooo--o-oo-----o-*ooooo---o--XXXXXXtt----o-o----------o------
-M-kk---g-tt------k----------g----ggXXXX--ggkk---k----*--r----k-g----------tt---g--g-XXX*------kr-----k--k*--rg---rg--XXXXXXtt---g-gg-----g-----r---F-
XXXXXXXXXXXXXXXXXXXXXXXXXXXXXXXXXXXXXXXX--XXXXXXXXXXXXXXXXXXXXXXXXXXXXXXXXXXXXXXXXXXXXXXXXXXXXXXXXXXXXXXXXXXXXXXXXXXXXXXXXXXXXXXXXXXXXXXXXXXXXXXXXXXXX
XXXXXXXXXXXXXXXXXXXXXXXXXXXXXXXXXXXXXXXX--XXXXXXXXXXXXXXXXXXXXXXXXXXXXXXXXXXXXXXXXXXXXXXXXXXXXXXXXXXXXXXXXXXXXXXXXXXXXXXXXXXXXXXXXXXXXXXXXXXXXXXXXXXXX
XXXXXXXXXXXXXXXXXXXXXXXXXXXXXXXXXXXXXXXX--XXXXXXXXXXXXXXXXXXXXXXXXXXXXXXXXXXXXXXXXXXXXXXXXXXXXXXXXXXXXXXXXXXXXXXXXXXXXXXXXXXXXXXXXXXXXXXXXXXXXXXXXXXXX
