------------------------------------------------------------------------------------------------------------------------------------------------------
-----------------------------------------------------------------------------o-----------------------------------------o------------------------------
--------o---------------------------------------------------------o-o------------------------------o--------------------------------------------------
-----------------------------------------------------------o------------------------------------------------------------------------------------------
------------------------------------------------------------------------------------------------------------------------------------------------------
----------------------------------------------------------------------------------------------o-----------------------------o-------------------------
-----------------------------g-------------------------------------------------------o------------------o---------------------------------------------
----------------------------oC2-------------------------------------------------ooo-------------------------------------------------------------------
----------------------------------o----------------ooooC------------------g------------------------------------------------oCoCo----------------------
-----------oooo-------oCo-o-------2oo2tt-----oCooo------------o2Cot------oCo---------k---*--------------------------2o2o-------------2oooo------------
--------------XXXgXXXX----------------tt-oCC--------tt-ttXXXXX---tt------------o----ttXXX*X-g--------g---------o2C--------tt--------------------------
---o------o---XXXC2CXX----------------tt-XXXXXXXXXXXtt-ttoooXX---tt-C22-------------ttXXXoC2CoXXX---o22o------------tt---XttXXXX-2o2------------------
-M------------XXXXXXXX------g---------ttrXXXXXXXXXXXttgttXXXXX---tt-----g-k--r--k-g-ttXXX*X---XXX-----g--g-----kk---tt-r-XttXXXX----r---kgk---------F-
XXXXXXXXXXXXXXXXXXXXXXXXXXXXXXXXXXXXXXXXXXXXXXXXXXXXXXXXXXXXXXXXXXXXXXXXXXXXXXXXXXXXXXXXXXXXXXXXXXXXXXXXXXXXXXXXXXXXXXXXXXXXXXXXXXXXXXXXXXXXXXXXXXXXXX
XXXXXXXXXXXXXXXXXXXXXXXXXXXXXXXXXXXXXXXXXXXXXXXXXXXXXXXXXXXXXXXXXXXXXXXXXXXXXXXXXXXXXXXXXXXXXXXXXXXXXXXXXXXXXXXXXXXXXXXXXXXXXXXXXXXXXXXXXXXXXXXXXXXXXX
XXXXXXXXXXXXXXXXXXXXXXXXXXXXXXXXXXXXXXXXXXXXXXXXXXXXXXXXXXXXXXXXXXXXXXXXXXXXXXXXXXXXXXXXXXXXXXXXXXXXXXXXXXXXXXXXXXXXXXXXXXXXXXXXXXXXXXXXXXXXXXXXXXXXXX
