----------------------------------------------------------------------------------------------o-----------------------------------o--o----------------
-----------o------------------------------------------------------------------------------------------------------------------------------------------
--------o---o--------------------------------------------------------------------------------------------------------------------------------o--------
-------------------------o----------------------------------------------------------------o-----------------------------------------------------------
-------------------------------------------------------------------------------------------------------------------------o-----o----------------------
---------------------------------------------------------------------------------------o---o--------------o--------o--------------------------o-------
-----------------------------------------------------o-----o------------------------------------------------------------------o---------------g-------
-------o---------o------------------o-------------CCCC----------------------------Cooo2------------------------o---ooCC--------------------o222-------
------------------oo---o----------ooo----o--------------k---------------------------------------o-----------------------------------------------------
-------oo-oooo--o--------k-------------------------r---tt-goo2oC-----------------------o------------------oo--------o----2ooo2-------C2oo---------o---
----------XXXXXX---XXX---XXXooo2oo-------------XXXXXXX-ttXXXXXX--oCooC-22C2o------------oCoo---o------------g-------o----tt-o--o2og-------------------
----------XXXXXX---XXXoC22XXXXXXX-o--------oC2oXXXXXXX-ttXX*XXX--------------oooo---------------CCoC-2oo---o2Co2X--------tt----o-X2o------------------
-M--------XXXXXX---XXX---XXXXXXXXg----g----kgrkXXXXXXXgttXX*XXX-----kg-g-k----------------g--gr---g-g-----g-grXXX-gg-----tt------X-gg---r-g---------F-
XXXXXXXXXXXXXXXXXXXXXXXXXXXXXXXXXXXXXXX-XXXXXXXXXXXXXXXXXXXXXXXXXXXXXXXXXXXXXXXXXXXXXXXXXXXXXXXXXXXXXXXXXXXXXXXXXXXXXXXXXXXXXXXX-XXXXXoXXXX-XXXXXXXXXX
XXXXXXXXXXXXXXXXXXXXXXXXXXXXXXXXXXXXXXX-XXXXXXXXXXXXXXXXXXXXXXXXXXXXXXXXXXXXXXXXXXXXXXXXXXXXXXXXXXXXXXXXXXXXXXXXXXXXXXXXXXXXXXXX-XXXXX-XXXX-XXXXXXXXXX
XXXXXXXXXXXXXXXXXXXXXXXXXXXXXXXXXXXXXXX-XXXXXXXXXXXXXXXXXXXXXXXXXXXXXXXXXXXXXXXXXXXXXXXXXXXXXXXXXXXXXXXXXXXXXXXXXXXXXXXXXXXXXXXX-XXXXX-XXXX-XXXXXXXXXX
