---------------------------o--------------------------------------o-----------------o---------------------------o-------------------------------------
-----o---------------------o-----------------------------------------------------------o------o-------------------------------------------------------
---------------o---------------o------------------------o-o--------------------------------------------------------------------------o--o-------------
----------------------------------o---o---------------------------------------------------------------------------------------o-----------------------
--o-----------------------------------------------------------o-----------------------------------------------------------------------------------o---
----------------------------------------------------------------------o----------------------------------------o--------------------------------------
-----------------------------------------------------------------------------------g--------------------------------------------o---------------------
--------------------------------------------o---------------2oC--------------------2oC---------Coo---------------------------------------2ooC---------
-----------oooC--o--CooCo-oCo22--ooo-------------------oCCC----------------------------o-----------------------------o-------------------------o------
----------------o2o-------g-----------------------------------tt----------------------o--g-----------ooCC---ooooo------------gooo2--------------------
-----------tt-----------XXXXXXXX---XXXooo-tt----oo2o----------tt---2CCo---o--ooo-------Co2o-----------------------o-------XXXXXX--o-2ooo--------------
-----------ttXXXX-------XXXXXXXX---XXXX---tt---o------tt------tt-----------XXXXX---------------------tt---------------2oCtXXXXXX---------------------o
-M------k--ttXXXX--kg---XXXXXXXX---XXXX-g-tt--r--gr---tt---g-gtt-------gg--XXXXX-----rg---r----------tt----grgg-----kgggttXXXXXX--g-----g----g------F-
XXXXXXXXXXXXXXXXXXXXXX--XXXXXXXXXXXXXXXXXXXXXXXXXXXXXXXXXXXXXXXXXXXXXXXXXXXXXXXXXXXXXXXXXXXXXXXXXXXXXXXXXXXXXXXXXXXXXXXXXXXXXXXXXXXXXXXXXXXXXXXXXXXXXX
XXXXXXXXXXXXXXXXXXXXXX--XXXXXXXXXXXXXXXXXXXXXXXXXXXXXXXXXXXXXXXXXXXXXXXXXXXXXXXXXXXXXXXXXXXXXXXXXXXXXXXXXXXXXXXXXXXXXXXXXXXXXXXXXXXXXXXXXXXXXXXXXXXXXX
XXXXXXXXXXXXXXXXXXXXXX--XXXXXXXXXXXXXXXXXXXXXXXXXXXXXXXXXXXXXXXXXXXXXXXXXXXXXXXXXXXXXXXXXXXXXXXXXXXXXXXXXXXXXXXXXXXXXXXXXXXXXXXXXXXXXXXXXXXXXXXXXXXXXX
