-------o-o------------------------------------------------o--------o--oo-----o--------------------------ooo-----o------------------o-----------o------
-------------------------------------------o------------------------------o--------------o----------------------------------o---------o---o-----------
------------------------------------------o-o----------o-------------o--o-oo------------------o------o-o---------------------------------o----o-------
---------------o-------------------o-------------o--o----------------o------------------------o----------o----o-----------------o---------------------
----o-----------------------o----------------------------------o----------------oo--------o------------o-----o--------o-------------------------------
----o----o--------------------------o----------------------o--------------------------o-------------------------------------------------o-oo----------
-------------------------------o------o-----------------------o------------------------------o------o-----------o------o---------------o--------------
-------------o-----oo-o--------------o----o--o-------------o-----o---------------o------o--------o---o----------o---ooo-oC2--o------------o-----------
---------------o-----------oo2-rg--------o------o--------------------------o---oo2o-o----------oo2oC-o2o-o-o--o-oCogo-----o-o2C---------oooo2-o------o
-------o-----------------------tt---o-tto------------o-----o-o-----o--o----2CCo----ggoC2oo--------tt--------------ttoo-o------oo-----o-------g------oo
-------o---o-o-ooog--oooo---o--tt-----tt-oo--Coo22---o2o-Coo2o---2oo--o222--k-gkr--tt-------oo----tt-tt---Co2-----tto---------g------2oo---XXXX----o--
--o---o--o-------XXXXXXXX------to2oCC-to2oo--------o------------oo-------XXXXXXXX--tt-tt---oooC---tt-tt-----XXXXo-tt--X--XXXXXX-o2ooo------XXXX-------
-M--k--rr----g-g-XXXXXXXXgkk---tt-----tt-g-g----------grg-kg-ggr---kg---gXXXXXXXXggtt-tt---gk----ktt-tt--k--XXXX--tt--X--XXXXXX----g--kg---XXXX----rF-
XXXXXXXXXXXXXXXXXXXXXXXXXXXXXXXXXXXXXXXXXXXXX--XXXXXXXXXXXXXXXXXXXXXXXXXXXXXXXXXXXXXXXXXXXXXXXX--XXXXXXXXXXXXXXX-XXXXXXXXXXXXXXXXXXXXXXXXo-XXXXXXXXXXX
XXXXXXXXXXXXXXXXXXXXXXXXXXXXXXXXXXXXXXXXXXXXX--XXXXXXXXXXXXXXXXXXXXXXXXXXXXXXXXXXXXXXXXXXXXXXXX--XXXXXXXXXXXXXXX-XXXXXXXXXXXXXXXXXXXXXXXXo-XXXXXXXXXXX
XXXXXXXXXXXXXXXXXXXXXXXXXXXXXXXXXXXXXXXXXXXXX--XXXXXXXXXXXXXXXXXXXXXXXXXXXXXXXXXXXXXXXXXXXXXXXX--XXXXXXXXXXXXXXX-XXXXXXXXXXXXXXXXXXXXXXXX--XXXXXXXXXXX
