------------------------------------------------------------------------------------------------------------------------------------------------------
------------------------------------------------------------------------------------------------------------------------------------------------------
------------------------------------------------------------------------------------------------------------------------------------------------------
------------------------------------------------------------------------------------------------------------------------------------------------------
------------------------------------------------------------------------------------------------------------------------------------------------------
------------------------------------------------------------------------------------------------------------------------------------------------------
--------------------------g---------------------------------------------------------------------------------------------------------------------------
--------------------------Coo-----------------g-----------------CoCo----------------------------------------------------------------------------------
-------------g-------------------------------o2C------oooo-22oC------------------g-------------g------------------------------------Co2o--------------
-------------CCo2C--------------g----------*-----------------------------Co2----o2o------------222o-------------ooC2-----------------------oooo-------
-------------------------------C22XCooXX---*-----------------XXXXXX------------------XXXooCC2-------2oo2-o2ooC------XXXXXXoo2o------------------------
----------XXXXXXX----C222-----XXXttXXttX---*-----XooC--------XXXXXX------------------XXX------------XXXXXXXXX-------XXXXXXX---------------------------
-M--------XXXXXXX-g----k------XXXttXXttXk--*gg--gXXXXg-g--g--XXXXXX--g-g----g-----rk-XXX----r--rg---XXXXXXXXX------gXXXXXXX-k-k---------g-g---------F-
XXXXXXXXXXXXXXXXXXXXXXXXXXXXXXXXXXXXXXXXXXXXXXXXXXXXXXXXXXXXXXXXXXXXXXXXXXXXXXXXXXXXXXXXXXXXXXXXXXXXXXXXXXXXXXXXXXXXXXXXXXXXXXXXXXXXXXXXXXXXXXXXXXXXXX
XXXXXXXXXXXXXXXXXXXXXXXXXXXXXXXXXXXXXXXXXXXXXXXXXXXXXXXXXXXXXXXXXXXXXXXXXXXXXXXXXXXXXXXXXXXXXXXXXXXXXXXXXXXXXXXXXXXXXXXXXXXXXXXXXXXXXXXXXXXXXXXXXXXXXX
XXXXXXXXXXXXXXXXXXXXXXXXXXXXXXXXXXXXXXXXXXXXXXXXXXXXXXXXXXXXXXXXXXXXXXXXXXXXXXXXXXXXXXXXXXXXXXXXXXXXXXXXXXXXXXXXXXXXXXXXXXXXXXXXXXXXXXXXXXXXXXXXXXXXXX
