------------------------------------------------------------------------------------------------------------------------------------------------------
------------------------------------------------------------------------------------------------------------------------------------------------------
----------------------------------------------------------------------------------------------------------------------------------------------------o-
------------------------------------------------------------------------------------------------------------------------------------------------------
-----------------------------------------------------------------------------------------------o------------------------------------------------------
----------------------------------------------------------------------------------------------------o----------------------------------------o--------
--------------------------------------------------------------------------------------------------o--------------tt--------------------tt-------------
-------------------------y-Y-g---------------------o------------------------------------------------------------ott-------------------gtt-----tt-F--XX
------------------------%%%%%%%---------------------------------------------o--o---------------y------y----------tt-------o-----%%%%%%%tttt%%-tt-XXXXX
-----------------o--o---|||||||--------Y--tt---------------------------------------o-----------XXXXXXXXX--------Gtt-go-o------G-|||||||tttt||-tt-XXXXX
------------------------|||||||-------%%%%tt---------g--------%%%%%tt--------------------------XXXXXXXXXXXXXXXXXXXXXXXXXXXXXXXXXXXXXXXXXXXXXXXXXXXXXXX
--------o---------------|||||||------o||||tt--------%%%%%-----|||||tt----%XXX------gGtt--G-g---XXXXXXXXXXXXXXXXXXXXXXXXXXXXXXXXXXXXXXXXXXXXXXXXXXXXXXX
------o-------G----o----|||||||-------||XXXXX------XXX|||-----|||||tt----|XXXg---%%%%tt%%%%%%%%XXXXXXXXXXXXXXXXXXXXXXXXXXXXXXXXXXXXXXXXXXXXXXXXXXXXXXX
XXXXXXX--o---XX------o--|||||||------G||XXXXXo-G---XXX||tt--Y-|||||tt----|XXXXXXXXXXXXXXXXXXXXXXXXXXXXXXXXXXXXXXXXXXXXXXXXXXXXXXXXXXXXXXXXXXXXXXXXXXXX
XXXXXXX------XX--XXXXX--||||XXXXXXXXXXXXXXXXX-%%%--XXX||ttXXXXXXXXXXXXXXXXXXXXXXXXXXXXXXXXXXXXXXXXXXXXXXXXXXXXXXXXXXXXXXXXXXXXXXXXXXXXXXXXXXXXXXXXXXXX
XXXXXXX--g---XXG-XXXXX--||||XXXXXXXXXXXXXXXXX-|||--XXX||ttXXXXXXXXXXXXXXXXXXXXXXXXXXXXXXXXXXXXXXXXXXXXXXXXXXXXXXXXXXXXXXXXXXXXXXXXXXXXXXXXXXXXXXXXXXXX
