------------------------------------------------------------------------------------------------------------------------------------------------------
------------------------------------------------------------------------------------------------------------------------------------------------------
----------tt------------------------------------------------------------------------------------------------------------------------------------------
----------tt---o-------------o---o----------G---------------------------------------------------------------------------------------------------------
----------tto------------o----tt-----------%%%--------------------------------------------------------------------------------------------------------
--------gGtt----------o-----%%tt--%%%-o--%%|||--------------------------------------------------------------------------------------------------------
-------XXXXXXXXXXXXXXXXXXXXXXXtt--|||----|||||-----------%%-------------------------------------------------------------------------------------------
-------XXXXXXXXXXXXXXXXXXXXXXXtt--|||----|||||-----------||----------o----------------------------------------GG--------------------------------------
-------XXXXXXXXXXXXXXXXXXXXXXXXXXXXXXXXXX|||||-----------||--tt------%%%%--o-----------------------%%-------%%%%%-------------------------------------
-------XXXXXXXXXXXXXXXXXXXXXXXXXXXXXXXXXX|||||--o--------||tttt---o--||||----------o---------------||-------|||||-------------------o-----------------
XXXXXXXXXXXXXXXXXXXXXXXXXXXXXXXXXXXXXXXXX|||||-----------||tttt------||||--------------------------||---tt--|||||------------%%-----------------------
XXXXXXXXXXXXXXXXXXXXXXXXXXXXXXXXXXXXXXXXX|||||----------g||tttt----G-||||-------%%---tt------------||---tt--|||||--o--------ott--------tt--G-y--------
XXXXXXXXXXXXXXXXXXXXXXXXXXXXXXXXXXXXXXXXXXXXXXXXXXXXXXXXXXXXXXXXXXXXXXXXXXXXXXXX||---tt------------||---tt--|||||------------tt------o-tttt%%tt-----o-
XXXXXXXXXXXXXXXXXXXXXXXXXXXXXXXXXXXXXXXXXXXXXXXXXXXXXXXXXXXXXXXXXXXXXXXXXXXXXXXX||-G-tt-g----------||---tt--|||||------------tt--------tttt||tt--F----
XXXXXXXXXXXXXXXXXXXXXXXXXXXXXXXXXXXXXXXXXXXXXXXXXXXXXXXXXXXXXXXXXXXXXXXXXXXXXXXXXXXXXXXXXXXXXXXXXXXXXXXXXXXXXXXXXXXXXXXXXXXXXXXXXXXXXXXXXXXXXXXXXXXXXX
XXXXXXXXXXXXXXXXXXXXXXXXXXXXXXXXXXXXXXXXXXXXXXXXXXXXXXXXXXXXXXXXXXXXXXXXXXXXXXXXXXXXXXXXXXXXXXXXXXXXXXXXXXXXXXXXXXXXXXXXXXXXXXXXXXXXXXXXXXXXXXXXXXXXXX
