----------------o----o--------------------------------------------------------------------------------------------------------------------------------
--------------------tt--------------------------------------------------------------------------------------------------------------------------------
--------------------tt--------------------------------------------------------------------------------------------------------------------------------
---------------gg---tt---------------oY----------o---------------------------------------------------------------------G------------------------------
-----------y--%%%%%%tt-g------------%%%%%%tt------tt-----------------------------------------------------------------%%%%%%----%%---------------------
XXXXXXXXXXXXXXXXXXXXXXXXXXXXXX----o-||||||tt------tt-----------------------------------------------------------------||||||----||---------------------
XXXXXXXXXXXXXXXXXXXXXXXXXXXXXX------||||||tt--ogo-tt-----------------------------------------------------------------||||||----||---------------------
XXXXXXXXXXXXXXXXXXXXXXXXXXXXXX------|||XXXXXXXXXXXXXXXXXX-tt---------------Y-----------------G-gg--------------------||||||----||--%%%----------------
XXXXXXXXXXXXXXXXXXXXXXXXXXXXXXXXXXXXXXXXXXXXXXXXXXXXXXXXX-tt-------------%%%%%-------------%%%%%%%%--------------o---||||||----||--|||----------------
XXXXXXXXXXXXXXXXXXXXXXXXXXXXXXXXXXXXXXXXXXXXXXXXXXXXXXXXX-tto------o--o-o|||tt---tt-----%%%||||||||---tt-----------tt||||||----||--|||--GG--Y-g-------
XXXXXXXXXXXXXXXXXXXXXXXXXXXXXXXXXXXXXXXXXXXXXXXXXXXXXXXXXGtt%%%%---------|||tt---tt-----|||||||||||---tto----oo----tt||tt||----||--|||-%%%%%%tt%------
XXXXXXXXXXXXXXXXXXXXXXXXXXXXXXXXXXXXXXXXXXXXXXXXXXXXXXXXXXXXXXX|---------|||tt---tt-----tt|||||||||---tt-----------tt||tt||----||--|||-||||||tt|-----o
XXXXXXXXXXXXXXXXXXXXXXXXXXXXXXXXXXXXXXXXXXXXXXXXXXXXXXXXXXXXXXX|-------XX|||tt---tt-----tt|||||||||---tt---o---g-g-tt||tt||----||-o|||o||||||tt|------
XXXXXXXXXXXXXXXXXXXXXXXXXXXXXXXXXXXXXXXXXXXXXXXXXXXXXXXXXXXXXXX|o----Y-XXXXXXXXXXXXXXXXXXXXXXXXXXXXXXXXXXXXXXXXXXXXXXX|tt||----||--|||-||||||tt|-F-gG-
XXXXXXXXXXXXXXXXXXXXXXXXXXXXXXXXXXXXXXXXXXXXXXXXXXXXXXXXXXXXXXXXXXXXXXXXXXXXXXXXXXXXXXXXXXXXXXXXXXXXXXXXXXXXXXXXXXXXXXXXXXXXXXXXXXXXXXXXXXXXXXXXXXXXXX
XXXXXXXXXXXXXXXXXXXXXXXXXXXXXXXXXXXXXXXXXXXXXXXXXXXXXXXXXXXXXXXXXXXXXXXXXXXXXXXXXXXXXXXXXXXXXXXXXXXXXXXXXXXXXXXXXXXXXXXXXXXXXXXXXXXXXXXXXXXXXXXXXXXXXX
