------------------------------------------------------------------------------------------------------------------------------------------------------
-------------------------------o-------------------------------------------------------------------------o--------------------------------------------
----------------------tt-----------------------------------------------------------------------------------------------------tt-----------------------
--------------o--G----tt------------------------------------------------------------------------o----------------------------tt-----------------------
----------o-----%tt%%%tt------------------%%----------------------o-------------------------tt------------gG-%%--Y---y---g-g-tt-y--------------------g
--------g----o--|tt|||tt------g-----------||-----------------------o---------%%-------------tt---------XXXXXXXXXXXXXXX%%%%%%%tt%%%%%%---------------%%
XXXXXXXXXXXXXXXXXXXXXXXXXXXXXXXX----------||--------------------------%%--o--||-------------tt--gg-----XXXXXXXXXXXXXXXXXXXXXXXX||||||---------------||
XXXXXXXXXXXXXXXXXXXXXXXXXXXXXXXX----------||--------------------------||-----||-------------tt%%%%%%--gXXXXXXXXXXXXXXXXXXXXXXXX||||||-------------o-||
XXXXXXXXXXXXXXXXXXXXXXXXXXXXXXXX----------||------%%------o----------y||o----||------------XXXXXXXXXXXXXXXXXXXXXXXXXXXXXXXXXXXXXX||||---tt--------tt||
XXXXXXXXXXXXXXXXXXXXXXXXXXXXXXXXXXXX------||------||------------XXXXXXXXXX---||--G-G--o----XXXXXXXXXXXXXXXXXXXXXXXXXXXXXXXXXXXXXX||||o--tt--------tt||
XXXXXXXXXXXXXXXXXXXXXXXXXXXXXXXXXXXX------||-o----||------------XXXXXXXXXXXXXXXXXXXXXX--y-gXXXXXXXXXXXXXXXXXXXXXXXXXXXXXXXXXXXXXX||||---tttt------tt||
XXXXXXXXXXXXXXXXXXXXXXXXXXXXXXXXXXXX------||------||----yy------XXXXXXXXXXXXXXXXXXXXXXXXXXXXXXXXXXXXXXXXXXXXXXXXXXXXXXXXXXXXXXXXX||||Y--tttt-----Ftt||
XXXXXXXXXXXXXXXXXXXXXXXXXXXXXXXXXXXXXXXXXXXXXXXXXXXXXXXXXXXXXXXXXXXXXXXXXXXXXXXXXXXXXXXXXXXXXXXXXXXXXXXXXXXXXXXXXXXXXXXXXXXXXXXXXXXXXXXXXXXXXXXXXXXXXX
XXXXXXXXXXXXXXXXXXXXXXXXXXXXXXXXXXXXXXXXXXXXXXXXXXXXXXXXXXXXXXXXXXXXXXXXXXXXXXXXXXXXXXXXXXXXXXXXXXXXXXXXXXXXXXXXXXXXXXXXXXXXXXXXXXXXXXXXXXXXXXXXXXXXXX
XXXXXXXXXXXXXXXXXXXXXXXXXXXXXXXXXXXXXXXXXXXXXXXXXXXXXXXXXXXXXXXXXXXXXXXXXXXXXXXXXXXXXXXXXXXXXXXXXXXXXXXXXXXXXXXXXXXXXXXXXXXXXXXXXXXXXXXXXXXXXXXXXXXXXX
XXXXXXXXXXXXXXXXXXXXXXXXXXXXXXXXXXXXXXXXXXXXXXXXXXXXXXXXXXXXXXXXXXXXXXXXXXXXXXXXXXXXXXXXXXXXXXXXXXXXXXXXXXXXXXXXXXXXXXXXXXXXXXXXXXXXXXXXXXXXXXXXXXXXXX
