------------------------------------------------------------------------------------------------------------------------------------------------------
------------------------------------------------------------------------------------------------------------------------------------------------------
------------------------------------------------------------------------------------------------------------------------------------------------------
--------tt--------------------------------------------------------------------------------------------------------------------o--------o-o------------
------o-tt--%%%---------------------------------------------%%%%%--G---------g---------------------------------------------------o----o------------o--
XXXXXXXXXXXXXtt-----tt--------------------------------------|||||-%%%-------%%%------------------------tt--------tt----------------o-----------------X
XXXXXXXXXXXXXtt-----tt--------------------------------------|||||-|||-----%%|||----------------------tttt--------tt------o--g------y-----------------X
XXXXXXXXXXXXXtt-----tt--------------------------------------|||||-|||-----|||||----------------------tttt--o-o---tt----o----XXXXXXXXXX-----o-----F---X
XXXXXXXXXXXXXtt----Gtt---o-o---------oo---------------------|||||-|||-----|||||-------------------o--tttt--------tt---------XXXXXXXXXXXXXXXXXXXXXXXXXX
XXXXXXXXXXXXXXXXXXXXXX----------------------oo------o-------|||||-|||-----|||||o----------------tt--XXXXXXXXXXXXXXXXXXXXXXXXXXXXXXXXXXXXXXXXXXXXXXXXXX
XXXXXXXXXXXXXXXXXXXXXX----o-----tt--------------------------|||||-|||-----||||tt----------------tt--XXXXXXXXXXXXXXXXXXXXXXXXXXXXXXXXXXXXXXXXXXXXXXXXXX
XXXXXXXXXXXXXXXXXXXXXX----------tt----tttt--------o---------|||||-|||---tt||||tt----------------tt--XXXXXXXXXXXXXXXXXXXXXXXXXXXXXXXXXXXXXXXXXXXXXXXXXX
XXXXXXXXXXXXXXXXXXXXXX--------G-tt--G-tttt---%XXX----tt-----||tt|-|||--ott|XXXXXX------o--------tt--XXXXXXXXXXXXXXXXXXXXXXXXXXXXXXXXXXXXXXXXXXXXXXXXXX
XXXXXXXXXXXXXXXXXXXXXXXXXXXXXXXXXXXXXXXXXXXX-|XXX--G-tt-----||tt|-|||---tt|XXXXXX----XXXXXXXXXXXXXXXXXXXXXXXXXXXXXXXXXXXXXXXXXXXXXXXXXXXXXXXXXXXXXXXXX
XXXXXXXXXXXXXXXXXXXXXXXXXXXXXXXXXXXXXXXXXXXXXXXXXXXXXXXXXXXXXXXXXXXXXXXXXXXXXXXXXXXXXXXXXXXXXXXXXXXXXXXXXXXXXXXXXXXXXXXXXXXXXXXXXXXXXXXXXXXXXXXXXXXXXX
XXXXXXXXXXXXXXXXXXXXXXXXXXXXXXXXXXXXXXXXXXXXXXXXXXXXXXXXXXXXXXXXXXXXXXXXXXXXXXXXXXXXXXXXXXXXXXXXXXXXXXXXXXXXXXXXXXXXXXXXXXXXXXXXXXXXXXXXXXXXXXXXXXXXXX
