------------------------------------------------------------------------------------------------------------------------------------------------------
------------------------------------------------------------------------------------------------------------------------------------------------------
------------------------------------------------------------------------------------------------------------------------------------------------------
------------------------------------------------------------------------------------------------------------------------------------------------------
------------------------------------------------------------------------------------------------------------------------------------------------------
------------LL----------------------------------------------------------------------------------------------------------------------------------------
------------------------------------------------------------------------------------------------------------------------------------------------------
------------------------------------------------------------------------------------------------------------------------------------------------------
------------------------------------------------------------------------------------------------------------------------------------------------------
-----------S@@S------------------------TT----------------------------tt--------------------------------------------------------------------tt---------
------tt-------------------------------TT----------------------------tt--------------------------------------------------------------------tt---------
------tt-------------------------------TT----------------------------tt-----------------------------------TT-------------------------------tt---------
------tt-------------------------------TT----------------------------tt-----------------------------------TT-------------------------------tt-------F-
-M----tt---------kk----------------g---TTyyy----------------------GG-tt----------yy--------------------r--TT--r------------------------gg--tt---gg--#-
XXXXXXXXXXXXXXXXXXXXX---XXXXXXXX---XXXXXXXXXXXXXXXXXXXXXXXXXX----XXXXXXXXXXXXXXXXXXXXXXXX---XXXXX-----XXXXXXXXXXX---XXXXXXX---XXXX-----XXXXXXXXXXXXXXX
XXXXXXXXXXXXXXXXXXXXX---XXXXXXXX---XXXXXXXXXXXXXXXXXXXXXXXXXX----XXXXXXXXXXXXXXXXXXXXXXXX---XXXXX-----XXXXXXXXXXX---XXXXXXX---XXXX-----XXXXXXXXXXXXXXX
